XXXXX
XK KX
X   X
X   X
XX XX
XX XXXXXXXXXXXX
XX XXXXX X X gX
XX XXXXX X X  X
XXA      D D  X
XX XXXXX X X  X
XX XXXXX X X  X
XX XXXXXXXXXXXX
XX XX
X   X
X   X
XK KX
XXXXX
Rooms: [[(0,0),(4,4)],[(5,0),(11,6)],[(12,0),(16,4)],[(5,7),(11,14)]]